00000000000000000000000
00000000000000000000000
00000000000000000000000
00000000000000000000000
00000000000000000000000
00000000000000000000000
00000000000000000000066
00000000000000000000666
00000000000000000006666
66666666666666666666666