00000000000000000000000
00000000000000000000000
00000000000000000000000
00000000000000000000000
00000000000000000000000
00055055000000000000000
00000000000000050000000
00000000000005550000000
55555555005555550005555