00000000000000000000000000000000000000000000
00000000000000000000000000000000000000000000
00000000000000000000000000000000000000000000
00000000000000000000000000000000000000000000
00000000000000000000000000000000000000000000
00000000000000000000000000000000000000000000
55500000000000000000005550000000000000000000
00000500000000055550000000000000000000000000
00000000000000000000000000005555500000000000
00000005555550000000000000000000000000000000
00000000000000000000000000000000000000000000
00555000000000000000000000000000005555550000
00000000000000000000000000000000000000000000
00000005555550000000000555550000000000000000
00000000000000000000000000000000000000000000
55555000000000000000000000000000000000005555
