000000000000000000000000000000000000000000000000000000000
000000000000000000000000000000000000000000000000000000000
000000000000000000000000000000000000000000000000000000000
400000000000000000000000000000000000000000000000000000000
000000000000000000000000000000000000000000000000000000000
000400000000000000000000000000000000000000000000000000000
000000000000000000000000000000000000000000000000000000000
400000004444444000444444000000000000000000000000000000000
000000000000000000000000000000000000444400000000000000000
000440000000000000000000004444440000000000000000000000000
000000000000000000444444400000000000000004444440000000000
000000000000000000000000000000000000000000000000000000000
000000444400440000000000000000000000000000000000044444440
000000000000000000004444444400000000000000000000000000000
000000000000000000000000000000000000000044444440000000000
000000000000444444000000000000444444440000000000000000000
000000000000000000000000000000000000000000000000000000000
004444400000000000000000000000000000000000000000000000000