00000000000000000000000000000000000000000000000000000
00000000000000000000000000000000000000000000000000000
00000000000000000000000000000000000000000000000000000
00000000000000000000066666666600066660000000000000000
66666666000000000000000000000000000000000000000000006
00000000066666666660000000000000000000000000000000666
00000000000000000000000000000000000000666666666000666
00000000000000000000066666666666000000000000000000666
00000000000000000000000000000000000000000000000000666
00000000000666666660000000000000000000000000006666666
00000000000666666660000000000000000000000006666666666
00000000666666666666666600000000000000000666666666666
66666666666666666666666666666666666666666666666666666