3333333333333333333333333333333333333333333333333333333333333333333333333
3333333333333333333333333333333333333333333333333300000033333333333333333
3333333333333333333333333333333333333333333333333300000033333333333333333
3333333333333333333333333333333333333333333333333300000333333333333333333
3333333333333333333333333333333333333333333333333300000000000000000000003
3333333303333333333333333333333333333333333333333333300000000000000000003
3333333303333333333333333333333333333333333333333333333000000000000000003
3333333300000000000000000000000000000000000000000000000300000000000000003
3333333300000000000000000000000000000000000000000000000330000000000000003
3333333300000000000000000000000000000000000000000000000333333300030000003
3333333330000000000000000000000000000000000000000000000000000000000030003
3333333333330000000003333000333333333000000000000000000000000000000000033
3333333300000000000000000000333333333000000000000000000000000000000000003
0000000000000033333000000000333333333333333000333333000033333300003333333
0000000000000000000000000000333333333333333000333333000033333300003333333
0000000000000000000003300000333333333333333000333333003333333300003333333
0000000333333330000003300000333333333333333000333333000033333300003333333
0000000333333333333333300000333333333333333000333333300033333300003333333
3333333333333333333333300000333333333333333000333333000033333300003333333