00000000000000000000000000000000000000000000000000000000000000
00000000000000000000000000000000000000000000000000000000000000
00000000000000000000000000000000000000000000000000000000000000
00000000000000000000000000000000000000000000000000000000000000
00000000000000000000000000000000000000000000000000000000000000
33000000000000000000000000000000000000000000000000000000000000
00030000000000000000000000000000000000000000000000000000000000
00000000000000000000000000000000000000000000000000000000000000
00000030000000000000000000000000000000000000000000000000000000
00000000300000000000333333330003333333300000000000000000000000
00000000000000000000000000000000000000000000000000000000000000
00000000000333333300000000000000000000000000000000000000000000
00000000000000000000000000000000000000000003333333300000000000
00000003300000000000333333333000000000000000000000000000000000
00000000000000000000000000000000000000000000000000000000000000
33333000000000333300000000000000000000000000000000000000000000
00000000000000000000000000000000000000000000000000000000000000
00000000000000000000000000000000000000000000000000000000000000
00000000000000000000000000000333330000000000000000000000000000
00000000000000000000000000000000000033333333000333333333333333
00000000000000000000000333300000000000000000000000000000000000
00000000000000000000000000000000000000000000000000000000000000
00000000033333333333000000000000000000000000000000000000000000