4444444444444444444444444444444444444444444444444444444444
4444444444444444444444444444444444444444444444444444444444
4000000000000000000000000000000000000000000000000000000004
4000000000000000000000000000000000000000000000000000000004
4000000000000000000000000000000000000000000000000000000004
4000000000000000000000000000000000000000000000000000000004
4000000000004440000444444444440000000004444440004400044444
4004444440000000000000044444440000000000000000000000044444
4000000000000000000000044444440000000000000000000000444444
4400000000000000000000044444440000000000000000000004444444
4400000000000000000000044444444444444000000000000444444444
4444444444000444400000044444444444444000000000000000444444
4000000000000000000000044444444444440000000444400000444444
4000000000000000000444444444444444444000000000000000444444
4000000000440000000444444444444444444000000000000444444444
4444444400000044444444444444444444444000000004444444444444
4444444000000044444444444444444444444444444444444444444444
4444444000400044444444444444444444444444444444444444444444
4444444000000044444444444444444444444444444444444444444444
4444444000000444444444444444444444444444444444444444444444
4444444444444444444444444444444444444444444444444444444444